00000000000000000000000000000000000000000
00000000000000000000000000000001000000000
00000100000000000000000000000000000000000
00000000003000000000000000000000330330330
00000000030300000000000000000000300000000
03333333300033300000000000000000300000000
00030000000000300000000000000000300000000
00000000000000300000000000000000300000000
00000000001000300000000000000000300000000
00030000000000300000000000000000300000000
00030000000002333300000000000000300000000
00032222200020000300000000000000300000001
00030000200020010300000000000000300000000
00000000200020000300000000000333300000000
00000010001000000300000000000300000000000
00030000000020000300000000000300200000000
00030000200020000300000000000300200000000
00030222200022220300000000000300222223333
00000020200020020300000000000300220020000
00030020200020020300000000000322220000000
00032220200022222300000000000300020020000
00030000000020000300000000000333022220000
00030000001020000300000000000003000020001
00030010000000001300000000000003000020000
00030000200020000300000000000003001020000
00030000200022222300000000000003000020000
00032222200000000030000000000003000020000
00030000200000000003000000000003000020000
00030000200000000003000000000003000020000
00030010000000000030000000000003000020000
00030000200022222300000000000003000020000
00030000201020000300000000000003000020000
00032220200020000300000000000003333333333
00030020200000010300000000000000000000000
00030020200020000300000000000100000000000
00030222200022222300000000000000000000000
00030000200020020300000000000000000000000
00030010000000020300000000000000000000000
00030000201020000300000000000000000000000
00030000200020010300000000000000000000000
side_length:1
