0000001001000000000000010010000000010100
0101000000000001000000000000000000000000
0000000010010000000000100100001000010000
0003333333333333333333333333333333333010
1003100020010200001000001020100200013000
0003000021001200100000000020000201013010
1003000020000200000000000020000200003000
0003001020000200001000100120100200103000
0003222222222200100000000022222222223000
0003001020000200000000000020000200003000
0003100020010200000010000020010200003100
0003000020000200010000010120000200103001
0103000020001200100000000020000200003000
0003222222222200000000000022222222223000
0013000000000000000010000100000010003000
0003010000000000001000001010000000003000
0103000001000010000000000100001000103100
0003010000010000010000100000100001003000
0013000000000000000000000000000000003010
0003001000000000100101000000001000003001
0003000010000100000000001001000100003000
0103010000000000000010000000000000013000
0003000000100000000000001000000010003000
0003010000001010100001000000001000013100
0003001001000000000000000001000010003000
0013000000001001000000001000000000003100
0003222222222400001000100022222222223000
0003000020000200000000000020000200003000
0003000120000200001010000020010200103000
0003100020000201000000010020000200003000
0103000020000200000000000021000200003110
0003222222222201000100001022222222223000
1003000020000200000000000020001201003000
0003000020010200001000010020000200103000
0003010020000200000000000020000200003000
0003000021000200100000010021000210003001
0003333333333333333333333333333333333000
1000000000000000000000000000000000000000
0000000000000000000000000000000000000000
0000100100001000001000001001010000100000
side_length:2.5